11111111111111111
1E1000000100000C1
10101111010111101
101001C1010100001
10110101010101011
10000101000101001
10111101111101101
10000000100000101
11111110111111101
1000001C100000001
10111011101111111
10001000001000001
11101111111011101
1C100000001010001
10111111101010111
100000000000100P1
11111111111111111