11111111111111111
1E100000000011111
10000111110011111
1P001110000011111
11111111111111111