1111111111
1000010001
1000011101
1P00000001
1111111111