111111111
100000001
100111001
100101111
100000001
111111111