1111111111T
10000100011
10000111011
1P000000011
11111111111