1111111111111
101CCCCCCCCC1
10CEC1111CCC1
1P0C111CCCCC1
1111111111111