1111111111111
1010000000001
1000011110E01
1P00111000001
1111111111111