1111111111111
101000000E001
1000011111001
1P00111000001
1111111111111