1111111111111
1C1C0000000C1
1100111100001
1P000C1E10001
1000000000001
1111111111111
