1111111111111
1C1C000000001
100E011110001
1P001110000C1
1111111111111