1111111111111
1P1000000E001
1000011111001
1000111000001
1111111111111