111111
1P0001
101001
101C01
1110E1
111111
