111111
1P0001
101001
101001
111001
111111
