111111
1P0001
111001
101001
111CE1
111111